11111111111111111111111111111111111111111111111111111111111111111
10000000000000000001000000000000000000000000000100000000000000001
10000000000000000001000000000000000000000000000100000000000000001
10000000000000000001000000000000000000000000000000000000000000001
10000000000000000001000000000000000000000000000000000000000000001
10000000000000000001000000000000000000000000000000000000000000001
10000000000000000001000000000000000000000000000000000000000000001
10000000000000000000000000000000000000000000000000000000000000001
10000000000000000000000000000000000000000000000000000000000000001
10000000000000000000000000000000000000000000000000000000000000001
10000000000000000000000000000000000000000000000000000000000000001
10000000000000000000000000000000000000000000000000000000000000001
10000000000000000000000000000000000000000000000000000000000000001
10000000000000000000000000000000000000000000000000000000000000001
10000000000000000000000000000000000000000000000000000000000000001
10000000000000000000000000000000000000000000000000000000000000001
10000000000000000000000000000000000000000000000000000000000000001
10000000000000000000000000000000000000000000000000000000000000001
10000000000000000000000000000000000000000000000000000000000000001
10000000000000000000000000000000000000000000000000000000000000001
10000000000000000000000000000000000000000000000000000000000000001
10000000000000000000000000000000000000000000000000000000000000001
10000000000000000000000000000000000000000000000000000000000000001
10000000111111111111111111100000000000000000000000000000000000001
10000000000000000000000000000000000000000000000000000000000000001
10000000000000000000000000000000000000000000000000000000000000001
10000000000000000000000000000000000000000000000000000000000000001
10000000000000000000000000000000000000000000000000000000000000001
10000000000000000000000000000000000000000000000000000000000000001
10000000000000000000000000000000000000111111111111111000000000001
10000000000000000000000000000000000000000000000000000000000000001
10000000000000000000000000000000000000000000000000000000000000001
10000000000000000000000000000111111110000000000000000000000000001
10000000000000000000000000000000000000000000000000000000000000001
10000000000000000000000000000000000000000000000000000000000000001
10000000000000000000000000000000000000000000000000000000000000001
10000000000000000000111111111111111111111000000000000000000000001
10000000000111111111000000000000000000000000000000000000000000001
11111110000000000000000000000000000000000000011111000000000000001
10000000000000000000000000001111110000000000000000000000000001101
11111111111111111111111111111111111111111111111111111111111111111

//TODO easy? - add side collision
       easy - add block health
       medium/tedious - add simple block animation
       unimportant - add sound and music


